a	Anton
b	Berta
c	Cäsar
d	Dora
e	Emil
f	Friedrich
g	Gustav
h	Heinrich
i	Ida
j	Julius
k	Kaufmann
l	Ludwig
m	Martha
n	Nordpol
o	Otto
p	Paula
q	Quelle
r	Richard
s	Samuel
t	Theodor
u	Ulrich
v	Viktor
w	Wilhelm
x	Xanthippe
y	Ypsilon
z	Zacharias
ß	Esszett
ä	Ärger
ö	Ökonom
ü	Übermut